Task Events:	2892970	Ok
General Info Count:	2892970	Ok
General Info:	Stats	Ok
Stats CPU Memory Info Count:	1	Ok
Stats CPU Memory Info:	Stats	Ok
Median CPU Count:	1	Ok
Median CPU Info:	Stats	Ok
Median Memory Count:	1	Ok
Median Memory Info:	Stats	Ok
Task Event Count:	9	Ok
Event 0 Info:	Stats	Ok
Event 1 Info:	Stats	Ok
Event 2 Info:	Stats	Ok
Event 3 Info:	Stats	Ok
Event 4 Info:	Stats	Ok
Event 5 Info:	Stats	Ok
Event 6 Info:	Stats	Ok
Event 7 Info:	Stats	Ok
Event 8 Info:	Stats	Ok
Ratio Count:	643930	Ok
Average Ratio Event Count:	4	Ok
Average Ratio Event 2 Info:	Stats	Ok
Average Ratio Event 3 Info:	Stats	Ok
Average Ratio Event 4 Info:	Stats	Ok
Average Ratio Event 6 Info:	Stats	Ok
Analysis Count:	5	Ok
Analysis Event 2 Info:	Stats	Ok
Analysis Event 3 Info:	Stats	Ok
Analysis Event 6 Info:	Stats	Ok
Analysis Event 4 Info:	Stats	Ok
Analysis General Type Info:	Stats	Ok
